00000000000000000000
00000000330000000000
00000003003000000000
00000000000000000000
00030003333033303000
00030003003030003000
00030003003030003000
00030003003030000000
00033303333033303000
00000000000000000000
00000000330000000000
00000000000000000000
01111112222221111110
00000000000000000000
00000000000000000000
