00000000000000000000
00000032000023000000
00000032000023000000
00000032000023000000
00000032000023000000
00000032200223000000
00000033333333000000
00000000000000000000
00000000000000000000
00000000000000000000
00000000000000000000
00000000022000000000
0122000000000000000
01000000000000000000
00000000000000000000