00000000000000000000
03300002000020000330
03000002000020000030
03000002000020000030
03000002000020000030
03000002200220000300
03000000000000000030
00000000000000000000
00011100000000111000
00000000000000000000
01000000000000000010
01000000000000000010
01220000000000000010
01000000000000000010
00000000000000000000